1111111111111
10010000000C1
1010011111001
1P0111E000001
1111111111111